......................................................
......................................................
......................................................
....................................C.................
..............................########################
.............##.........##..............#...........#.
.............#...........#..............#...........#.
.........1...#...........#..............##.........##.
##############################........................
......................................................