.............................................
.............................................
.............................................
.............................................
..####................#......................
..........####.....................###.#.....
......................C......................
..1...................#....................##
#######..####################################
.............................................