.............................................
.............................................
.............................................
...E.........................................
.#####......E.........#..............E.......
..........####.....................###.#.....
...............E......E....................C.
#.1......#.....#......#.........E..........##
#######..####################################
.............................................